一丘之貉	一丘之貉	hé
一叶扁舟	一叶扁舟	piān
一小撮	一小撮	cuō
一幢	一幢	zhuàng
一抔黄土	一抔黄土	póu 
一撮毛	一撮毛	zuǒ
一暴十寒	一暴十寒	pù
一气呵成	一气呵成	hē
一沓纸	一沓纸	dá
一爿	一爿	pán
一绺	一绺	liǔ
一行人	一行人	xíng
一蹴而就	一蹴而就	cù
万俟（姓）	万俟（姓）	mòqí
万马齐喑	万马齐喑	yīn
三缄其口	三缄其口	jiān
三闾	三闾	lǘ
上供	上供	gòng
下颌	下颌	hé
不亦乐乎	不亦乐乎	lè
不即不离	不即不离	jí
不可估量	不可估量	liáng
不可胜数	不可胜数	shèng
不啻	不啻	chì
不塞不流	不塞不流	sè
不容置喙	不容置喙	huì
不屑	不屑	xiè
不瘟不火	不瘟不火	wēn
不着边际	不着边际	zhuó
不胫而走	不胫而走	jìng
不蔓不枝	不蔓不枝	màn
不辍	不辍	chuò
与会	与会	yù
丛冢	丛冢	zhǒng
东施效颦	东施效颦	pín
东莞	东莞	guǎn
丢三落四	丢三落四	là
严惩不贷	严惩不贷	chéng
丧魂落魄	丧魂落魄	pò
为虎作伥	为虎作伥	wèi
乘客	乘客	chéng
乜斜	乜斜	miēxie
乳臭未干	乳臭未干	xiù
事迹	事迹	jì
亘古未有	亘古未有	gèn
亚洲	亚洲	yà
亢旱	亢旱	kàng
亲家	亲家	qìng
亲戚	亲戚	qi
亲昵	亲昵	nì
亵渎	亵渎	xiè
仇（姓）	仇（姓）	qiú
仓廪	仓廪	lǐn
仫佬族	仫佬族	mù
任（姓）	任（姓）	rén
仿佛	仿佛	fú
伉俪	伉俪	kàng
休憩	休憩	qì
众擎易举	众擎易举	qíng
会稽	会稽	huìjī
伛偻	伛偻	yǔlǚ
伶俜	伶俜	pīng
伺候	伺候	cì
似的	似的	shì
体己	体己	tīji
余勇可贾	余勇可贾	gǔ
作料	作料	zuòliao
佝偻	佝偻	gōu
佞幸	佞幸	nìng
佣金	佣金	yòng
佯攻	佯攻	yáng
佶屈聱牙	佶屈聱牙	jí áo
佼好	佼好	jiǎo
侗族	侗族	dòng
侘傺	侘傺	chàchì
供给	供给	jǐ
侪辈	侪辈	chái
便宜行事	便宜行事	biàn
俊俏	俊俏	jùn
俨然	俨然	yǎn
俯瞰	俯瞰	kàn
倏尔	倏尔	shū 
倔强	倔强	jiàng
倨傲	倨傲	jù
倩影	倩影	qiàn
倾轧	倾轧	yà
偃旗息鼓	偃旗息鼓	yǎn
偈子	偈子	jì
偌大	偌大	ruò
停泊	停泊	bó
傣族	傣族	dǎi
僧侣	僧侣	sēng
僭越	僭越	jiàn
兄弟阋墙	兄弟阋墙	xì
兜鍪	兜鍪	móu
入殓	入殓	liàn
关卡	关卡	qiǎ
内讧	内讧	hòng
冒顿	冒顿	Mòdú
冠心病	冠心病	guān
冲床	冲床	chòng
准噶尔	准噶尔	gá
凤冠霞帔	凤冠霞帔	pèi
凫水	凫水	fú
凹陷	凹陷	āo
分蘖	分蘖	niè
切中肯綮	切中肯綮	qièqìng
刊载	刊载	zǎi
刚劲	刚劲	jìng
刚愎自用	刚愎自用	bì
创伤	创伤	chuāng
削减	削减	xuē
剥豆	剥豆	bāo
剽窃	剽窃	piāo
功亏一篑	功亏一篑	kuì
功高德劭	功高德劭	shào
动人心弦	动人心弦	xián
勖勉	勖勉	xù
勾当	勾当	gòu
包庇	包庇	bì
包扎	包扎	zā
匍匐	匍匐	fú
区（姓）	区（姓）	ōu
千里迢迢	千里迢迢	tiáo
华山	华山	huà
华（姓）	华（姓）	huà
卓有成效	卓有成效	zhuó
单于	单于	chán
单（姓）	单（姓）	shàn
博闻强识	博闻强识	zhì
卡宾枪	卡宾枪	kǎ
即景生情	即景生情	jí
卷帙	卷帙	zhì
卷帙浩繁	卷帙浩繁	zhì
压轴	压轴	zhòu 
厦门	厦门	xià
参差	参差	cēncī
反诘	反诘	jié
反躬自省	反躬自省	xǐng
发憷	发憷	chù
发酵	发酵	jiào
古刹	古刹	chà
句读	句读	dòu
召开	召开	zhào
可汗	可汗	kè
叱咤风云	叱咤风云	chì
叶公好龙	叶公好龙	yè
吃呛了	吃呛了	qiāng
同仇敌忾	同仇敌忾	kài
后羿	后羿	yì
后裔	后裔	yì
吐蕃	吐蕃	bō
否极泰来	否极泰来	pǐ
含情脉脉	含情脉脉	mò
含英咀华	含英咀华	jǔhuá
呕心沥血	呕心沥血	ǒu 
呱呱坠地	呱呱坠地	gū
呷一口酒	呷一口酒	xiā
命运多舛	命运多舛	chuǎn
咀嚼	咀嚼	jué
咄咄怪事	咄咄怪事	duō
咆哮	咆哮	xiào
和泥	和泥	huó
和煦	和煦	xù
和稀泥	和稀泥	huò
咕咕而泣	咕咕而泣	gū
咖喱	咖喱	gālí
咯血	咯血	kǎ
咳嗽	咳嗽	sou
咸与维新	咸与维新	yù
哀戚	哀戚	qī
哂纳	哂纳	shěn
哈达	哈达	hǎ
哪吒	哪吒	né zhā
唱片	唱片	piàn
啜泣	啜泣	chuò
啼饥号寒	啼饥号寒	háo
喋血	喋血	dié
喝令	喝令	hè
喷香	喷香	pèn
嗔怪	嗔怪	chēn
嗜好	嗜好	shì
嗟叹	嗟叹	jiē
嗤之以鼻	嗤之以鼻	chī
嗫嚅	嗫嚅	nièrú
嗷嗷待哺	嗷嗷待哺	bǔ
嗾使	嗾使	sǒu
噤若寒蝉	噤若寒蝉	jìn
噬啮	噬啮	shì
噻唑	噻唑	sāizuò
回纥	回纥	hé
国帑	国帑	tǎng
图穷匕见	图穷匕见	xiàn
圩子	圩子	wéi
垂涎三尺	垂涎三尺	xián
垂髫	垂髫	tiáo
垓下	垓下	gāi
堤防	堤防	dī
堵塞	堵塞	sè
塑料	塑料	sù
墨翟	墨翟	dí
士大夫	士大夫	dà
处之泰然	处之泰然	chǔ
处女	处女	chǔ
处理	处理	chǔ
复辟	复辟	bì
夏丏尊	夏丏尊	miǎn
夔州	夔州	kuí
夙兴夜寐	夙兴夜寐	sù
夜阑人静	夜阑人静	lán
大不韪	大不韪	wěi
大厦	大厦	shà
大发横财	大发横财	hèng
大模大样	大模大样	mú
大纛	大纛	dào
大肆渲染	大肆渲染	xuàn
大腹便便	大腹便便	pián
天下为公	天下为公	wéi
天崩地坼	天崩地坼	chè
太监	太监	jiàn
央浼	央浼	měi
夯实	夯实	hāng
奇葩	奇葩	pā
契诃夫	契诃夫	hē
奢靡	奢靡	mí
女娲	女娲	wā
奴颜婢膝	奴颜婢膝	bì
奸狡诡谲	奸狡诡谲	jué
好逸恶劳	好逸恶劳	wù
如丧考妣	如丧考妣	bǐ
如法炮制	如法炮制	páo
妻孥	妻孥	nú
委靡	委靡	mǐ
姹紫嫣红	姹紫嫣红	chà
娉婷	娉婷	pīng
娴静	娴静	xián
婆娑	婆娑	suō
媲美	媲美	pì
嫉妒	嫉妒	jí
嫔妃	嫔妃	pín
嬗变	嬗变	shàn
嬷嬷	嬷嬷	mó
孽根	孽根	niè
宁（姓）	宁（姓）	níng
宝藏	宝藏	zàng
宫商角徵羽	宫商角徵羽	jué zhǐ
家畜	家畜	chù
宽绰	宽绰	chuo
宿将	宿将	sù
寒碜	寒碜	chen
寡廉鲜耻	寡廉鲜耻	xiǎn
寥廓	寥廓	kuò
对峙	对峙	zhì
对称	对称	chèn
封妻荫子	封妻荫子	yìn
尉迟（姓）	尉迟（姓）	Yùchí
小篆	小篆	zhuàn
少安毋躁	少安毋躁	shǎowú
尴尬	尴尬	gān
尽管	尽管	jǐn
层见叠出	层见叠出	xiàn
层见错出	层见错出	jiàn
居心叵测	居心叵测	pǒ
屏气凝神	屏气凝神	bǐng
屏除	屏除	bǐng
屏风	屏风	píng
山大王	山大王	dài
岌岌可危	岌岌可危	jí
崔嵬	崔嵬	wéi
崚嶒	崚嶒	léng
嶙峋	嶙峋	xún
巨擘	巨擘	bò
差强人意	差强人意	chā
差等	差等	chà
差错	差错	chā
巷道	巷道	hàngdào
干涸	干涸	hé
并行不悖	并行不悖	bèi
广袤	广袤	mào
庖丁	庖丁	páo
庠序	庠序	xiáng
度德量力	度德量力	duó
廿四	廿四	niàn
开门揖盗	开门揖盗	yī
引吭高歌	引吭高歌	háng
弥笃	弥笃	dǔ
弱不禁风	弱不禁风	jīn
弹劾	弹劾	hé
强人所难	强人所难	qiǎng
强迫	强迫	qiǎng
当年（指同一年）	当年（指同一年）	dàng
当年（指过去）	当年（指过去）	dāng
徇情枉法	徇情枉法	xùn
得不偿失	得不偿失	cháng
徜徉	徜徉	cháng
心广体胖	心广体胖	pán
忍俊不禁	忍俊不禁	jīn
忐忑不安	忐忑不安	tǎntè
忖度	忖度	cǔn
忧心忡忡	忧心忡忡	chōng
忸怩不安	忸怩不安	niǔ
怂恿	怂恿	sǒng
怏怏	怏怏	yàng
怔怔	怔怔	zhèng
怙恶不悛	怙恶不悛	hùquān
怫然	怫然	fú
怯弱	怯弱	qiè
怵惕	怵惕	chù
恁时	恁时	nèn
恣睢	恣睢	zìsuī
恣行无忌	恣行无忌	zì
恪守不渝	恪守不渝	kè
恫吓	恫吓	hè
恬不知耻	恬不知耻	tián
恸哭	恸哭	tòng
悄然	悄然	qiǎo
悉心	悉心	xī
悚然	悚然	sǒng
悭吝	悭吝	qiān
悲怆	悲怆	chuàng
惝恍迷离	惝恍迷离	huǎng
惩罚	惩罚	chéng
惬意	惬意	qiè
惴惴不安	惴惴不安	zhuì
感喟	感喟	kuì
愤懑	愤懑	mèn
慰藉	慰藉	jiè
憎恶	憎恶	zēng
戎马倥偬	戎马倥偬	kǒngzǒng
戏谑	戏谑	xuè
戕害	戕害	qiāng
戗水	戗水	qiāng
戛然	戛然	jiá
戡乱	戡乱	kān
户枢不蠹	户枢不蠹	dù
扒手	扒手	pá
打场	打场	cháng
打场子	打场子	chǎng
执拗	执拗	niù
扪心自问	扪心自问	mén
扫帚	扫帚	sàozhou
把水澄清	把水澄清	dèng
披星戴月	披星戴月	pī
抶而扑之	抶而扑之	chì
押解	押解	jiè
拈阄	拈阄	niānjiū
拓本	拓本	tà
拗口	拗口	ào
拘泥	拘泥	nì
拙劣	拙劣	zhuō
择菜	择菜	zhái
拮据	拮据	jiéjū
拾掇	拾掇	duo
拾级而上	拾级而上	shè
按捺不住	按捺不住	nà
挟持	挟持	xié
挨打	挨打	ái
振聋发聩	振聋发聩	kuì
挹	挹	yì
捋	捋	luō  
捧场	捧场	chǎng
掂量	掂量	liang
掣肘	掣肘	chè
推诿	推诿	wěi
掮客	掮客	qián
掳掠	掳掠	lǔ
掸族	掸族	shàn
提供	提供	gōng
提纲挈领	提纲挈领	qiè
插科打诨	插科打诨	hùn
揠苗助长	揠苗助长	yà
揩油	揩油	kāi
揶揄	揶揄	yé
搦战	搦战	nuò
搭讪	搭讪	shàn
摇曳多姿	摇曳多姿	yè
摈弃	摈弃	bìn
摩挲	摩挲	suō
撩拨	撩拨	liáo
撩起	撩起	liāo
擂台	擂台	lèi
擂鼓	擂鼓	léi
攒射	攒射	cuán
攫取	攫取	jué
支吾	支吾	wú
收讫	收讫	qì
敕令	敕令	chì
敝帚自珍	敝帚自珍	zhǒu
数见不鲜	数见不鲜	shuòxiān
整饬	整饬	chì
文以载道	文以载道	zài
斗转参横	斗转参横	shēn
斡旋	斡旋	wò
断壁颓垣	断壁颓垣	yuán
旌旗	旌旗	jīng
旖旎	旖旎	yǐ
既往不咎	既往不咎	jiù
日晷	日晷	guǐ
昂扬	昂扬	áng
明眸善睐	明眸善睐	lài
星宿	星宿	xiù
春华秋实	春华秋实	huá
是耶非耶	是耶非耶	yé
晁盖	晁盖	cháo
晕车	晕车	yùn
暖和	暖和	huo
暴戾	暴戾	lì
暴殄天物	暴殄天物	tiǎn
曝光	曝光	bào
曩者	曩者	nǎng
曲尽其妙	曲尽其妙	qū
有恃无恐	有恃无恐	shì
望风披靡	望风披靡	mǐ
木屐	木屐	jī
木樨	木樨	xi
未雨绸缪	未雨绸缪	móu
朴刀	朴刀	pō
朴（姓）	朴（姓）	piáo
机杼	机杼	zhù
杀一儆百	杀一儆百	jǐng
杂糅	杂糅	róu
杌陧之象	杌陧之象	wùniè
束手待毙	束手待毙	shù
杳然	杳然	yǎo
枞树	枞树	cōng
柏（姓）	柏（姓）	bǎi
某人	某人	mǒu
柞蚕	柞蚕	zuò
查（姓）	查（姓）	zhā
桀骜不驯	桀骜不驯	xùn
框架	框架	kuàng
桎梏	桎梏	gù
桑梓	桑梓	zǐ
桔梗	桔梗	jiégěng
档次	档次	dàng
桴止响腾	桴止响腾	fú
梦魇	梦魇	yǎn
梵文	梵文	fàn
棕榈	棕榈	lǘ
棺椁	棺椁	guǒ
椎心痛恨	椎心痛恨	chuí
椽子	椽子	chuán
楔子	楔子	xiē
樊哙	樊哙	kuài
模具	模具	mú
模式	模式	mó
模棱	模棱	léng
横祸	横祸	hèng
檄文	檄文	xí
檩条	檩条	lǐn
欺侮	欺侮	wǔ
歃血	歃血	shà
歆享	歆享	xīn
殒身不恤	殒身不恤	xù
殚精竭虑	殚精竭虑	dān
殷红	殷红	yān
毗邻	毗邻	pí
毛遂自荐	毛遂自荐	suì
民穷财匮	民穷财匮	kuì
民脂民膏	民脂民膏	zhī
气喘吁吁	气喘吁吁	xū
气馁	气馁	něi
氛围	氛围	fēn
水浒	水浒	hǔ
水獭	水獭	tǎ
永遇乐	永遇乐	lè
汩汩滔滔	汩汩滔滔	gǔ
沆瀣一气	沆瀣一气	hàngxiè
沐猴而冠	沐猴而冠	guàn
没齿难忘	没齿难忘	mò
沮丧	沮丧	jǔ
沸反盈天	沸反盈天	fèi
油坊	油坊	fáng
沼气	沼气	zhǎo
泡桐	泡桐	pāo
泥古	泥古	nì
泥泞	泥泞	nìng
泥淖	泥淖	nào
泫然流涕	泫然流涕	xuàn
泯灭	泯灭	mǐn
活塞	活塞	sāi
流水汤汤	流水汤汤	shāng
流水淙淙	流水淙淙	cóng
浅濑	浅濑	lài
济济一堂	济济一堂	jǐ
浑身解数	浑身解数	xiè
浣溪沙	浣溪沙	huàn
浩淼	浩淼	miǎo
海参崴	海参崴	wǎi
海市蜃楼	海市蜃楼	shèn
浸渍	浸渍	zì
涅槃	涅槃	pán
消弭	消弭	mǐ
涑阳	涑阳	sù
涔涔	涔涔	cén
涪江	涪江	fú
淆乱乾坤	淆乱乾坤	xiáo
淋病	淋病	lìn
清冽	清冽	liè
渌水	渌水	lù
渐染	渐染	jiān
渑池	渑池	miǎn
渔父	渔父	fǔ
渣滓	渣滓	zǐ
游弋	游弋	yì
湍急	湍急	tuān
湮没	湮没	yān
溃烂	溃烂	kuì
溃脓	溃脓	huì
溘然长逝	溘然长逝	kè
溥仪	溥仪	pǔ
溯本求源	溯本求源	sù
溷浊	溷浊	hùn
溺水	溺水	nì
溽暑	溽暑	rù
滑稽	滑稽	jī
滞钝	滞钝	dùn
潋滟	潋滟	liànyàn
潜能	潜能	qián
潸然泪下	潸然泪下	shān
澄清事实	澄清事实	chéng
澎湃	澎湃	pài
濒临	濒临	bīn
濯濯童山	濯濯童山	zhuó
火钵	火钵	bō
炮烙	炮烙	luò
炮羊肉	炮羊肉	bāo
炽热	炽热	chì
烙印	烙印	lào
烜赫一时	烜赫一时	xuǎn
煞尾	煞尾	shā
煞白	煞白	shà
熊罴	熊罴	pí
熟稔	熟稔	rěn
熠熠发光	熠熠发光	yì
熨帖	熨帖	yù
牛虻	牛虻	méng
牟取	牟取	móu
牟（姓）	牟（姓）	Móu
牵累	牵累	lěi
犄角	犄角	jī
犒赏	犒赏	kào
犯而不校	犯而不校	jiào
狙击	狙击	jū
狡黠	狡黠	xiá
狩猎	狩猎	shòu
猱猴	猱猴	náo
玄奘	玄奘	zàng
玷污	玷污	diàn
班蝥	班蝥	máo
琥珀	琥珀	pò
瑰丽	瑰丽	guī
璀璨	璀璨	cuǐ
瓜葛	瓜葛	gé
甘之如饴	甘之如饴	yí
生拉硬拽	生拉硬拽	zhuài
田塍	田塍	chéng
甲胄	甲胄	zhòu
畏葸不前	畏葸不前	xǐ
番禺	番禺	pān
畸形	畸形	jī
畸轻畸重	畸轻畸重	jī
疏浚	疏浚	jùn
疟疾	疟疾	nüè ji
疲沓	疲沓	ta
疾风劲草	疾风劲草	jìng
病入膏肓	病入膏肓	huāng
痉挛	痉挛	jìng
痤疮	痤疮	cuó
瘐毙	瘐毙	yǔ
瘦削	瘦削	xuē
癖性	癖性	pǐ
癸酉	癸酉	guǐyǒu
白术	白术	zhú
百舸	百舸	gě
皈依	皈依	guī
皱缬	皱缬	xié
监生	监生	jiàn
盖（姓）	盖（姓）	gě/gài
盘桓	盘桓	huán
盟誓	盟誓	méng
盥洗	盥洗	guàn
目不暇接	目不暇接	xiá
目眩	目眩	xuàn
直言不讳	直言不讳	huì
相形见绌	相形见绌	chù
相机行事	相机行事	xiàng
相濡以沫	相濡以沫	rú
着眼	着眼	zhuó
睚眦必报	睚眦必报	yázì
睿智	睿智	ruì
瞠目结舌	瞠目结舌	chēng
瞭望	瞭望	liào
矍铄	矍铄	jué
矜夸	矜夸	jīn
矩形	矩形	jǔ
矫揉造作	矫揉造作	jiǎo
石碣	石碣	jié
砖坯	砖坯	pī
砥柱	砥柱	dǐ
碑帖	碑帖	tiè 
磕绊	磕绊	kē
祛暑	祛暑	qū
禅让	禅让	shàn
秘鲁	秘鲁	bì
租赁	租赁	lìn
秭归	秭归	zǐ
秸秆	秸秆	jiē
稗官野史	稗官野史	bài
穴居	穴居	xué
空城计	空城计	kōng
穿凿	穿凿	záo
突兀	突兀	wù
窈窕	窈窕	yǎo
窗明几净	窗明几净	jī
窠臼	窠臼	kē
笑靥	笑靥	yè
符合	符合	fú
筚路蓝缕	筚路蓝缕	bì
筵席	筵席	yán
管窥蠡测	管窥蠡测	lí
箪食壶浆	箪食壶浆	sì
箴言	箴言	zhēn
簸箕	簸箕	bòji
籀文	籀文	zhòu
米芾	米芾	fú
籴米	籴米	dí
籼米	籼米	xiān
粗犷	粗犷	guǎng
粜米	粜米	tiào
粳米	粳米	jīng
糜费	糜费	mí
糟粕	糟粕	pò
糯米	糯米	nuò
素昧平生	素昧平生	mèi
累累果实	累累果实	léi
累臣	累臣	léi
繁冗拖沓	繁冗拖沓	rǒng
纤夫	纤夫	qiàn
纤维	纤维	xiān
纨绔子弟	纨绔子弟	kù
纵横捭阖	纵横捭阖	bǎi
细菌	细菌	jūn
结了果子	结了果子	jiē
绠短汲深	绠短汲深	gěngjí
绦虫	绦虫	tāo
绮丽多彩	绮丽多彩	qǐ
绯红	绯红	fēi
绾结	绾结	wǎn
绿林	绿林	lù
缁衣	缁衣	zī
缜密	缜密	zhěn
缫丝	缫丝	sāo
缴械	缴械	xiè
罄竹难书	罄竹难书	qìng
罢黜	罢黜	chù
罪愆	罪愆	qiān
罪行累累	罪行累累	lěi
罹难	罹难	lí
羞赧	羞赧	nǎn
羹匙	羹匙	chí
羼杂	羼杂	chàn
翌日	翌日	yì
翕然	翕然	xī
翘板	翘板	qiào
翘首	翘首	qiáo
翩然起舞	翩然起舞	piān
翩跹	翩跹	piān
老妪能解	老妪能解	yù
耄耋	耄耋	dié
耠地	耠地	huō
耷拉	耷拉	dāla
聆听	聆听	líng
聒噪	聒噪	guō
联袂	联袂	mèi
肄业	肄业	yì
肇事	肇事	zhào
股肱	股肱	gōng
肴馔	肴馔	zhuàn
胜券在握	胜券在握	quàn
胳臂	胳臂	bei
胼胝	胼胝	zhī
脊梁	脊梁	jǐ
脑髓	脑髓	suǐ
脖颈子	脖颈子	gěng
脚踝	脚踝	huái
腌臜	腌臜	ā
腾挪跌宕	腾挪跌宕	dàng
膂力	膂力	lǚ
臀部	臀部	tún
臧否人物	臧否人物	pǐ
自作自受	自作自受	zuò
自怨自艾	自怨自艾	yì
臻于郅治	臻于郅治	zhēnzhì
舂米	舂米	chōng
舌苔	舌苔	tāi
舐犊情深	舐犊情深	shì
舟楫	舟楫	jí
舷窗	舷窗	xián
船坞	船坞	wù
艄公	艄公	shāo
艨艟	艨艟	méngchōng
良莠不齐	良莠不齐	yǒu
色厉内荏	色厉内荏	rěn
芟夷大难	芟夷大难	shān
芬芳馥郁	芬芳馥郁	fù
苑囿	苑囿	yòu
苤蓝	苤蓝	piě lan
苦心孤诣	苦心孤诣	yì
苫布	苫布	shàn
范蠡	范蠡	lǐ
茎叶	茎叶	jīng
茕茕孑立	茕茕孑立	qióng
草坂	草坂	bǎn
草苫子	草苫子	shān
草菅人命	草菅人命	jiān
草长莺飞	草长莺飞	zhǎng
荫凉	荫凉	yìn
荷枪	荷枪	hè
荷蓧	荷蓧	hèdiào
荼毒生灵	荼毒生灵	tú
莅临	莅临	lì
莘莘学子	莘莘学子	shēn
莞尔	莞尔	wǎn
莫邪	莫邪	yé
莲花落	莲花落	lào
菁华	菁华	jīng
菲薄	菲薄	fěi
落在后面	落在后面	là
落枕	落枕	lào
葳蕤	葳蕤	ruí
蒋光鼐	蒋光鼐	nài
蓄养	蓄养	xù
蓊蓊郁郁	蓊蓊郁郁	wěng
蓓蕾	蓓蕾	bèi
蓦地	蓦地	mò dì
薅草	薅草	hāo
藐视	藐视	miǎo
藻饰	藻饰	zǎo
虔诚	虔诚	qián
虚与委蛇	虚与委蛇	wēiyí
虫豸	虫豸	zhì
蚌埠	蚌埠	Bèngbù
蚍蜉撼树	蚍蜉撼树	pí
蚝油	蚝油	háo
蛤蚌	蛤蚌	gébàng
蛤蟆	蛤蟆	hámá
蛮横	蛮横	hèng
蛮横无理	蛮横无理	hèng
蛰伏	蛰伏	zhé
蜕化	蜕化	tuì
蜚声	蜚声	fēi
蝙蝠	蝙蝠	biān
螳臂当车	螳臂当车	dāng
蟾蜍	蟾蜍	chú
血泊	血泊	pō
血流漂杵	血流漂杵	chǔ
行同狗彘	行同狗彘	zhì
衣锦还乡	衣锦还乡	yī
衰绖	衰绖	cuīdié
袅娜	袅娜	nuó
袅袅炊烟	袅袅炊烟	niǎo
装帧	装帧	zhēn
装载	装载	zài
裨益	裨益	bì
裨补阙漏	裨补阙漏	bì
覃（姓）	覃（姓）	qín
觊觎	觊觎	yú
觐见	觐见	jìn
解元	解元	jiè
解（姓）	解（姓）	xiè
觥筹交错	觥筹交错	gōng
譬喻	譬喻	pì
讥诮	讥诮	qiào
讪讪	讪讪	shàn
讴歌	讴歌	ōu
讷言敏行	讷言敏行	nè
讹诈	讹诈	é
论语	论语	lún
请帖	请帖	tiě
谄上欺下	谄上欺下	chǎn
谙习	谙习	ān
谥号	谥号	shì
谰言	谰言	lán
豁免	豁免	huò
豇豆	豇豆	jiāng
豪放不羁	豪放不羁	jī
贝壳	贝壳	ké
负箧	负箧	qiè
负隅顽抗	负隅顽抗	yú
责难	责难	nàn
贫血	贫血	xuè
贬谪	贬谪	zhé
赋比兴	赋比兴	xīng
赍钱	赍钱	jī
赏赉	赏赉	lài
赚人	赚人	zuàn
赝品	赝品	yàn
起碇	起碇	dìng
越俎代庖	越俎代庖	zǔ
趋之若鹜	趋之若鹜	wù
趑趄不前	趑趄不前	zījū
跛腿	跛腿	bǒ
跻身	跻身	jī
踉踉跄跄	踉踉跄跄	liàng qiàng
踟蹰不前	踟蹰不前	chíchú
踯躅不前	踯躅不前	zhízhú
踽踽独行	踽踽独行	jǔ
蹉跎	蹉跎	cuō
蹊跷	蹊跷	qīqiāo
蹒跚	蹒跚	pán
蹩进	蹩进	bié
身陷囹圄	身陷囹圄	língyǔ
躯壳	躯壳	qiào
车骑	车骑	qí
轧钢	轧钢	zhá
转捩点	转捩点	liè
软绵绵	软绵绵	miān
轻佻	轻佻	tiāo
载歌载舞	载歌载舞	zài
辐射	辐射	fú
辘轳	辘轳	lùlu
迄今	迄今	qì
过称	过称	chèng
迤逦	迤逦	yǐ
迥乎不同	迥乎不同	jiǒng
迫击炮	迫击炮	pǎi
迸发	迸发	bèng
退避三舍	退避三舍	shè
通缉	通缉	jī
逡巡	逡巡	qūn
逮捕	逮捕	dài
逮蚊子	逮蚊子	dǎi
道观	道观	guàn
遴选	遴选	lín
邂逅	邂逅	xiè
邋遢	邋遢	lātā
那（姓）	那（姓）	Nā
郢都	郢都	yǐng
郫县	郫县	pí
酗酒	酗酒	xù
酥油	酥油	sū
酩酊	酩酊	dǐng
酹酒	酹酒	lèi
醍醐灌顶	醍醐灌顶	tíhú
醪酒	醪酒	láo
醴酪	醴酪	lǐ
采邑	采邑	cài
释迦牟尼	释迦牟尼	móu
量才为用	量才为用	liàng
鈐记	鈐记	qián
鏖战	鏖战	áo
钗钏	钗钏	chuàn
钗钿	钗钿	chāi diàn
钱其琛	钱其琛	chēn
钻床	钻床	zuàn
铤而走险	铤而走险	tǐng
锁钥	锁钥	yuè
锱铢必较	锱铢必较	zī
锲而不舍	锲而不舍	qiè
长歌当哭	长歌当哭	dàng
长颈鹿	长颈鹿	jǐng
门槛	门槛	kǎn
间不容发	间不容发	jiānfà
阐述	阐述	chǎn
阜盛	阜盛	fù
阴霾	阴霾	mái
阿弥陀佛	阿弥陀佛	ē
阿房宫	阿房宫	páng
阿谀奉承	阿谀奉承	ēyú
附近	附近	fù
陆虞侯	陆虞侯	yúhóu
降幂	降幂	mì
陡然	陡然	dǒu
隽永	隽永	juàn
隽秀	隽秀	jùn
雇佣	雇佣	yōng
雪茄	雪茄	jiā
零趸	零趸	dǔn
霰雪	霰雪	xiàn
青睐	青睐	lài
青苔	青苔	tái
青蒿	青蒿	hāo
靓女	靓女	liàng
静谧	静谧	mì
靛青	靛青	diàn
靡靡之音	靡靡之音	mǐ
面面相觑	面面相觑	qù
鞑靼	鞑靼	dádá
鞭挞	鞭挞	tà
鞭笞	鞭笞	chī
鞭辟入里	鞭辟入里	pì
顿开茅塞	顿开茅塞	sè
颀长	颀长	qí
频仍	频仍	réng
颔联	颔联	hàn
颠簸	颠簸	bǒ
颠踬	颠踬	zhì
颤抖	颤抖	chàn
风声鹤唳	风声鹤唳	lì
风尘仆仆	风尘仆仆	pú
风流倜傥	风流倜傥	tì
风靡一时	风靡一时	mǐ
饮鸩止渴	饮鸩止渴	zhèn
饼铛	饼铛	chēng
饿殍遍野	饿殍遍野	piǎo
首创	首创	chuàng 
香菌	香菌	jùn
香蕈	香蕈	xùn
马鬣	马鬣	liè
驯服	驯服	xùn
驾驭	驾驭	yù
骁将	骁将	xiāo
骈文	骈文	pián
骠骑	骠骑	piàoqí
骨殖	骨殖	shi
骨碌	骨碌	gūlu
高丽	高丽	lí
高屋建瓴	高屋建瓴	líng
高擎	高擎	qíng
鬻官	鬻官	yù
鲜妍	鲜妍	yán
鳏夫	鳏夫	guān
鳞次栉比	鳞次栉比	zhì
鹰隼	鹰隼	sǔn
麻痹	麻痹	bì
麾下	麾下	huī
黄澄澄	黄澄澄	dēng
黑魆魆	黑魆魆	xū
黑黝黝	黑黝黝	yǒu
鼻衄	鼻衄	nǜ
龃龉	龃龉	jǔyǔ
龋齿	龋齿	qǔ
龟裂	龟裂	jūn